################################################################
#.........#....................##..............................#
#.........#....................................................#
#.........#....................................................#
#.........#....................................................#
#.........#############........................................#
#...............#..............................................#
#...............#..............................................#
#...............#..............................................#
#.....#..#..#...#..............................................#
#...............#..............................................#
#...............#..............................................#
#.....#..#..#..................................................#
#..............................................................#
#..............................................................#
#..............................................................#
#..............................................................#
#.....................######..#................................#
#.....................#.......#................................#
#....................##.###.###.........................#......#
#....................##.....#........................##........#
#....................##.#####........................##.#......#
#....................#.#.......................................#
#....................#..#...............................#......#
#..............................................................#
#..............................................................#
#..............................................................#
#..............................................................#
#..............................##..............................#
#..............................##..............................#
#..............................##..............................#
################################################################
