################
#..............#
#..............#
#.....##########
#..............#
#..............#
#..............#
#..............#
#..............#
#..............#
#..............#
#....#.........#
#..............#
#..............#
#..............#
################
